25,25,25,25,25,25,25,25,25,25,25,25,25,25,25,25,25,25,25,25
25,0,0,0,0,0,0,0,0,0,0,0,0,0,0,0,0,0,0,25
25,0,0,0,0,0,0,0,0,0,0,0,0,0,0,0,0,0,0,25
25,0,0,0,0,0,0,0,0,0,0,0,0,0,0,0,0,0,0,25
25,0,0,0,0,0,0,0,0,0,0,0,0,0,0,0,0,0,0,25
25,0,0,0,0,0,0,0,0,0,0,0,0,0,0,0,0,0,0,25
25,0,0,0,0,0,0,0,0,0,0,0,0,0,0,0,0,0,0,25
25,0,0,0,0,0,0,0,0,0,0,0,0,0,0,0,0,0,0,25
25,0,0,0,0,0,0,0,0,0,0,0,0,0,0,0,0,0,0,25
25,0,0,0,0,0,0,0,0,0,0,0,0,0,0,0,0,0,0,25
25,0,0,0,0,0,0,0,0,25,25,25,0,0,0,0,0,0,0,25
25,0,0,0,0,0,0,0,0,25,25,25,0,0,0,0,0,0,0,25
25,0,0,0,0,0,25,25,25,25,25,25,0,0,0,0,0,0,0,25
25,0,0,0,0,0,25,25,25,25,25,25,0,0,0,0,0,0,0,25
25,0,0,0,0,25,25,25,25,25,25,25,25,25,25,25,0,0,0,25
25,0,0,0,0,25,25,25,25,25,25,25,25,25,25,25,0,0,0,25
25,0,25,25,25,25,25,25,25,25,25,25,25,25,25,25,0,0,0,25
25,25,25,25,25,25,25,25,25,25,25,25,25,25,25,25,25,25,25,25
25,25,25,25,25,25,25,25,25,25,25,25,25,25,25,25,25,25,25,25
25,25,25,25,25,25,25,25,25,25,25,25,25,25,25,25,25,25,25,25

